31,30
/
GGGGGGGGGGGGGGGGGGGGGGGGGGGGGGG;
GGGGGGGGGGGGPPPPPPPGGGGGGGGGGGG;
GPPPGGGGGGGGPGGGGGPGGGGGGGGPPPG;
GPGPTTTTTTTTPGGGGGPTTTTTTTTPGPG;
GPPPGGGTGGGGPGGGGGPGGGGTGGGPPPG;
GGPGGPPPPPGGPGGGGGPGGPPPPPGGPGG;
GGPGPPGGGPPGPPPPPPPGPPGGGPPGPGG;
GGPGPGGGGGPGGGGPGGGGPGGGGGPGPGG;
GGPPPPPPPPPPPPPPPPPPPPPPPPPPPGG;
GGGGGTGGGPGGGGGGGGGGGPGGGTGGGGG;
GGGGGTTTTPGTGGGGGGGTGPTTTTGGGGG;
GGGGGTGGGPGGGGGGGGGGGPGGGTGGGGG;
GGGGGTGGGPPGGGGGGGGGPPGGGTGGGGG;
GGGGGTGGGGPTTTTTTTTTPGGGGTGGGGG;
GGGGGTGGGGPGGGGTGGGGPGGGGTGGGGG;
GGGGGTGGGGPTTTTTTTTTPGGGGTGGGGG;
GGGGGTGGGGPGGGGTGGGGPGGGGTGGGGG;
GGGGGTGGGGPTTTTTTTTTPGGGGTGGGGG;
GGGGGTGGGGPGGGGTGGGGPGGGGTGGGGG;
GGGGGTGGGGPPPPPPPPPPPGGGGTGGGGG;
GGGGGTGGGPPGTGGTGGTGPPGGGTGGGGG;
GGGGGTGGPPGGTTTTTTTGGPPGGTGGGGG;
GGGGGTGPPGGGGGTGTGGGGGPPGTGGGGG;
GGGGGTGPGGGGGGTGTGGGGGGPGTGGGGG;
GGGGGTGPGGGGGGTGTGGGGGGPGTGGGGG;
GGGGGTGPGGGGGGTGTGGGGGGPGTGGGGG;
GGGGPPPPGGGGGGTGTGGGGGGPPPPGGGG;
GGGGPGGPGGGGGGTTTGGGGGGPGGPGGGG;
GGGGPPPPGGGGGGGGGGGGGGGPPPPGGGG;
GGGGGGGGGGGGGGGGGGGGGGGGGGGGGGG;
/
35
/
rat,1,0,26,28,south,True,false,0,0 rat,1,0,26,28,south,False,false,0,0 rat,1,0,4,28,south,True,false,0,0 rat,1,0,10,12,south,True,false,0,0 rat,1,0,10,12,south,False,false,0,0 rat,1,0,7,5,south,False,false,0,0 rat,1,0,13,1,north,True,false,0,0 rat,1,0,1,2,south,False,false,0,0 rat,1,0,7,5,south,True,false,0,0
/
180
/
0
/
bomb,15,0,0 gas,20,0,0 sterilize,30,0,0 maleGenderChange,45,0,0 femaleGenderChange,45,0,0 stopSign,15,0,0 deathRat,90,0,0 poison,45,0,0
/
0
/
0,0,0,0,0,0,0,0
/
100
/
0
/
0
/
0