30,30
/
GGGGGGGGGGGGGGGGGGGGGGGGGGGGGG;
GGGGGGGGGGGGGGGGGGGGGGGGGGGGGG;
GGGGGPGGGGGGGGGGGGGGGGGGGGGGGG;
GGGGGPGGGGGGGGGGGGGGGGGGGGGGGG;
GGGGGPGPPPGGGGGGGGGGGGGGGGGGGG;
GGGGGPGPGPGGGGGGGGGGGGGGGGGGGG;
GGGPPPPPPPGGGGGGGGGGGGGGGGGGGG;
GPPPGGPGGPGGGGGGGGGGGGGGGGGGGG;
GPGTTTPGGPGGGGGGGGGGGGGGGGGGGG;
GPGGGGPGGPPPPGGGGGGGGGGGGGGGGG;
GPPPPGPPPPGGPGGGGGGGGGGGGGGGGG;
GGGGPPPGGGGGPGGGPPGGGGGGGGGGGG;
GGGGGGPGGPPPPGGGGPPGGGGGGGGGGG;
GGGGGPPPPPGGGGGGGGPGGGGGGGGGGG;
GGGGGGGGGGGGGGGGGGPGGGGGGGGGGG;
GGGGGGGGGGGGGGGGGGPGGGGGGGGGGG;
GGGGGGGGGGGGGGGGGGPGGGGGGGGGGG;
GGGGGGGGGGGGGGGGGGPGGGGGGGGGGG;
GGGGGGGGGGGGGGGGGGPGGGGGGGGGGG;
GGGGGGGGGGGGGGGGGGGGGGGGGGGGGG;
GGGGGGGGGGGGGGGGGGGGGGGGGGGGGG;
GGGGGGGGGGGGGGGGGGGGGGGGGGGGGG;
GGGGGGGGGGGGGGGGGGGGGGGGGGGGGG;
GGGGGGGGGGGGGGGGGGGGGGGGGGGGGG;
GGGGGGGGGGGGGGGGGGGGGGGGGGGGGG;
GGGGGGGGGGGGGGGGGGGGGGGGGGGGGG;
GGGGGGGGGGGGGGGGGGGGGGGGGGGGGG;
GGGGGGGGGGGGGGGGGGGGGGGGGGGGGG;
GGGGGGGGGGGGGGGGGGGGGGGGGGGGGG;
GGGGGGGGGGGGGGGGGGGGGGGGGGGGGG;

/
5
/
rat,3,0,5,3,north,True,false,0,0 rat,3,0,7,6,south,true,false,0,0
/
180
/
0
/
bomb,5,0,0 gas,10,0,0 sterilize,6,0,0 maleGenderChange,12,0,0 femaleGenderChange,12,0,0 stopSign,10,0,0 deathRat,20,0,0 poison,12,0,0
/
0
/
0,0,0,0,0,0,0,0
/
100
/
0
/
0