20,20
/
GGGGGGGGGGGGGGGGGGGG;
GGGGGGGGGGGGGGGGGGGG;
GGGGGPGGGGGGGGGGGGGG;
GGGGGPGGGGGGGGGGGGGG;
GGGGGPGPPPGGGGGGGGGG;
GGGGGPGPGPGGGGGGGGGG;
GGGPPPPPPPGGGGGGGGGG;
GPPPGGPGGPGGGGGGGGGG;
GPGTTTPGGPGGGGGGGGGG;
GPGGGGPGGPPPPGGGGGGG;
GPPPPGPPPPGGPGGGGGGG;
GGGGPPPGGGGGPGGGPPGG;
GGGGGGPGGPPPPGGGGPPG;
GGGGGPPPPPGGGGGGGGPG;
GGGGGGGGGGGGGGGGGGPG;
GGGGGGGGGGGGGGGGGGPG;
GGGGGGGGGGGGGGGGGGPG;
GGGGGGGGGGGGGGGGGGPG;
GGGGGGGGGGGGGGGGGGPG;
GGGGGGGGGGGGGGGGGGGG;

/
5
/
5,3,True,north 7,6,True,south
/
180
/
0
/
Bomb,5 Gas,10 Sterilisation,6 MaleSexChange,12 FemaleSexChange,12 NoEntrySign,10 DeathRat,20