25,21
/
GGGGGGGGGGGGGGGGGGGGGGGGG;
GPPPPPPPPPPGGGPPPPPPPPPPG;
GPGGTGGTGGPTTTPGGGGGGGGPG;
GPGGTGGTGGPGPGPGPPPPPPGPG;
GPGGTPPTGGPTTTPGPGPGGPGPG;
GPTTTGGTTTPGGGPGPPPPPPGPG;
GPGGTPPTGGPGGGPGPGPGGPGPG;
GPGGTGGTGGPGGGPGPPPPPPGPG;
GPGGTGGTGGPTTTPGPGGGGGGPG;
GPPPPPPPPPPGTGPPPPPPPPPPG;
GTGGGGGGGGTTPTTGGGGGGGGTG;
GPTTTTTTTTPGTGPPPPPPPPPPG;
GPGPGGGGPGPTTTPGTGGGGGGPG;
GPGPPGGPPGPGGGPGPPPPPGGPG;
GPGGPGGPGGPGGGPGPGGGPPGPG;
GPGGPPPPGGPGGGPGPGGGGPTPG;
GPGGPGGPGGPTTTPGPGGGPPGPG;
GPGPPGGPPGPGPGPGPPPPPGGPG;
GPGPGGGGPGPTTTPGTGGGGGGPG;
GPTTTTTTTTPGGGPPPPPPPPPPG;
GGGGGGGGGGGGGGGGGGGGGGGGG;
/
10
/
rat,1,2,1,east,True,0,false,0 rat,1,18,3,east,True,0,false,0 rat,1,21,3,west,false,0,false,0 rat,1,21,6,north,false,0,false,0 rat,1,18,5,north,false,0,false,0 rat,1,5,15,north,true,0,false,0
/
180
/
0
/
bomb,15,0,0 gas,15,0,0 sterilize,30,0,0 maleGenderChange,45,0,0 femaleGenderChange,45,0,0 stopSign,15,0,0 deathRat,90,0,0 poison,45,0,0
/
0
/
0,0,0,0,0,0,0,0