15
g g g g g g g g g g g g g g g
g g g g g g g g g g g g g g g
g g g g g p g g g g g g g g g
g g g g g p g g g g g g g g g
g g g g g p g p p p g g g g g
g g g g g p g p g p g g g g g
g g g p p p p p p p g g g g g
g p p p g g p g g p g g g g g
g p g t t t p g g p g g g g g
g p g g g g p g g p p p p g g
g p p p p g p p p p g g p g g
g g g g p p p g g g g g p g g
g g g g g g p g g p p p p g g
g g g g g p p p p p g g g g g
g g g g g g g g g g g g g g g
/
rat 4 2 m
rat 4 3 f